                  _____         _           _                   
                 / ____|       | |         | |                  
                | (___    ___  | | __ ___  | |__    __ _  _ __  
                 \___ \  / _ \ | |/ // _ \ | '_ \  / _` || '_ \ 
                 ____) || (_) ||   <| (_) || |_) || (_| || | | |
                |_____/  \___/ |_|\_\\___/ |_.__/  \__,_||_| |_|